______________________________
|..MMM...................DDDD|
|..MMM...................DDDD|
|..MMM...................DDDD|
|........................DDDD|
|...........SSS..............|
|...........SSS..............|
|...........SSS..............|
|............................|
|............................|
|CCC@.............WWW........|
|CCCC.............WWW........|
|CCCC.............WWW........|
|CCCC........................|
______________________________